{
    "zones": [
        "A1",
        "A2",
        "A3",
        "A4",
        "B1",
        "B2",
        "B3",
        "B4",
        "C1",
        "C2",
        "C3",
        "C4",
        "D1",
        "D2",
        "D3",
        "D4"
    ],
    "traffic_multipliers": {
        "normal": 1.0,
        "rush_hour": 1.8,
        "night": 0.7
    },
    "distances": {
        "A1": {
            "A1": 0,
            "A2": 2,
            "A3": 4,
            "A4": 6,
            "B1": 2,
            "B2": 4,
            "B3": 6,
            "B4": 8,
            "C1": 4,
            "C2": 6,
            "C3": 8,
            "C4": 10,
            "D1": 6,
            "D2": 8,
            "D3": 10,
            "D4": 12
        },
        "A2": {
            "A1": 2,
            "A2": 0,
            "A3": 2,
            "A4": 4,
            "B1": 4,
            "B2": 2,
            "B3": 4,
            "B4": 6,
            "C1": 6,
            "C2": 4,
            "C3": 6,
            "C4": 8,
            "D1": 8,
            "D2": 6,
            "D3": 8,
            "D4": 10
        },
        "A3": {
            "A1": 4,
            "A2": 2,
            "A3": 0,
            "A4": 2,
            "B1": 6,
            "B2": 4,
            "B3": 2,
            "B4": 4,
            "C1": 8,
            "C2": 6,
            "C3": 4,
            "C4": 6,
            "D1": 10,
            "D2": 8,
            "D3": 6,
            "D4": 8
        },
        "A4": {
            "A1": 6,
            "A2": 4,
            "A3": 2,
            "A4": 0,
            "B1": 8,
            "B2": 6,
            "B3": 4,
            "B4": 2,
            "C1": 10,
            "C2": 8,
            "C3": 6,
            "C4": 4,
            "D1": 12,
            "D2": 10,
            "D3": 8,
            "D4": 6
        },
        "B1": {
            "A1": 2,
            "A2": 4,
            "A3": 6,
            "A4": 8,
            "B1": 0,
            "B2": 2,
            "B3": 4,
            "B4": 6,
            "C1": 2,
            "C2": 4,
            "C3": 6,
            "C4": 8,
            "D1": 4,
            "D2": 6,
            "D3": 8,
            "D4": 10
        },
        "B2": {
            "A1": 4,
            "A2": 2,
            "A3": 4,
            "A4": 6,
            "B1": 2,
            "B2": 0,
            "B3": 2,
            "B4": 4,
            "C1": 4,
            "C2": 2,
            "C3": 4,
            "C4": 6,
            "D1": 6,
            "D2": 4,
            "D3": 6,
            "D4": 8
        },
        "B3": {
            "A1": 6,
            "A2": 4,
            "A3": 2,
            "A4": 4,
            "B1": 4,
            "B2": 2,
            "B3": 0,
            "B4": 2,
            "C1": 6,
            "C2": 4,
            "C3": 2,
            "C4": 4,
            "D1": 8,
            "D2": 6,
            "D3": 4,
            "D4": 6
        },
        "B4": {
            "A1": 8,
            "A2": 6,
            "A3": 4,
            "A4": 2,
            "B1": 6,
            "B2": 4,
            "B3": 2,
            "B4": 0,
            "C1": 8,
            "C2": 6,
            "C3": 4,
            "C4": 2,
            "D1": 10,
            "D2": 8,
            "D3": 6,
            "D4": 4
        },
        "C1": {
            "A1": 4,
            "A2": 6,
            "A3": 8,
            "A4": 10,
            "B1": 2,
            "B2": 4,
            "B3": 6,
            "B4": 8,
            "C1": 0,
            "C2": 2,
            "C3": 4,
            "C4": 6,
            "D1": 2,
            "D2": 4,
            "D3": 6,
            "D4": 8
        },
        "C2": {
            "A1": 6,
            "A2": 4,
            "A3": 6,
            "A4": 8,
            "B1": 4,
            "B2": 2,
            "B3": 4,
            "B4": 6,
            "C1": 2,
            "C2": 0,
            "C3": 2,
            "C4": 4,
            "D1": 4,
            "D2": 2,
            "D3": 4,
            "D4": 6
        },
        "C3": {
            "A1": 8,
            "A2": 6,
            "A3": 4,
            "A4": 6,
            "B1": 6,
            "B2": 4,
            "B3": 2,
            "B4": 4,
            "C1": 4,
            "C2": 2,
            "C3": 0,
            "C4": 2,
            "D1": 6,
            "D2": 4,
            "D3": 2,
            "D4": 4
        },
        "C4": {
            "A1": 10,
            "A2": 8,
            "A3": 6,
            "A4": 4,
            "B1": 8,
            "B2": 6,
            "B3": 4,
            "B4": 2,
            "C1": 6,
            "C2": 4,
            "C3": 2,
            "C4": 0,
            "D1": 8,
            "D2": 6,
            "D3": 4,
            "D4": 2
        },
        "D1": {
            "A1": 6,
            "A2": 8,
            "A3": 10,
            "A4": 12,
            "B1": 4,
            "B2": 6,
            "B3": 8,
            "B4": 10,
            "C1": 2,
            "C2": 4,
            "C3": 6,
            "C4": 8,
            "D1": 0,
            "D2": 2,
            "D3": 4,
            "D4": 6
        },
        "D2": {
            "A1": 8,
            "A2": 6,
            "A3": 8,
            "A4": 10,
            "B1": 6,
            "B2": 4,
            "B3": 6,
            "B4": 8,
            "C1": 4,
            "C2": 2,
            "C3": 4,
            "C4": 6,
            "D1": 2,
            "D2": 0,
            "D3": 2,
            "D4": 4
        },
        "D3": {
            "A1": 10,
            "A2": 8,
            "A3": 6,
            "A4": 8,
            "B1": 8,
            "B2": 6,
            "B3": 4,
            "B4": 6,
            "C1": 6,
            "C2": 4,
            "C3": 2,
            "C4": 4,
            "D1": 4,
            "D2": 2,
            "D3": 0,
            "D4": 2
        },
        "D4": {
            "A1": 12,
            "A2": 10,
            "A3": 8,
            "A4": 6,
            "B1": 10,
            "B2": 8,
            "B3": 6,
            "B4": 4,
            "C1": 8,
            "C2": 6,
            "C3": 4,
            "C4": 2,
            "D1": 6,
            "D2": 4,
            "D3": 2,
            "D4": 0
        }
    }
}